10
o.........
..........
.oo.......
..........
..........
..........
..o......o
..........
..........
..........
